1111111111111
111100E0M1111
1111M00001111
11110MC001111
1111000M01111
11110000M1111
1111M00001111
1111000M01111
11110000M1111
1111M0C001111
11110M0001111
1111000M01111
11110000M1111
1111M0C001111
11110M0001111
1111000M01111
11110000M1111
111111P111111
1111111111111