111111
1E0001
10C001
1P0E01
111111