111111
1P0001
10C001
1P0E01
111111