11111
1C011
10001
1P0E1
11111
